wwwwwwwwww
w........w
w..b..b..w
w........w
wsswwww..w
wAs......w
wss.b2.b.w
w........w
wwwwwwwwww