wwwwwwwwwwwwwwwwwwwwwwwwwww
w.......w..s..w..s..w....sw
w1......w.b...w.b...w...b.w
w....w..w..w..w..w..w..w..w
wss..w.....w.....w.....w..w
wss1.w.....w.....w.....w..w
wss..w..w..w..w..w..w..w..w
wAs1....w.....w.....w.....w
wss..w..w..w..w..w..w..w..w
wss1.w.....w.....w.....w..w
wss..w.....w.....w.....w..w
w....w..w..w..w..w..w..w..w
w1......w.b...w.b...w...b.w
w.......w..s..w..s..w....sw
wwwwwwwwwwwwwwwwwwwwwwwwwww