wwwwwwwwwwwwwwwwwwwwwwwwwww
w...........sss...........w
w..b..b..w..sss..w..b..b..w
w........w.......w........w
w..wwww..w..www..w..wwww..w
w.........................w
wss......w..sss..w......ssw
wss..2...w..sAs..w..222.ssw
wss......w..sss..w......ssw
w.........................w
w..wwww..w..www..w..wwww..w
w........w.......w........w
w..b..b..w..sss..w..b..b..w
w...........sss...........w
wwwwwwwwwwwwwwwwwwwwwwwwwww